   EA                            textures/west.png
SO        textures/north.png



NO  textures/south.png

F      255,    38,     64

WE  textures/east.png



C 0, 0, 0

1111111111111111111111111
10011000010000000000F00S1
1000110000000000111111111
1000110000000000110001001
1000000000100000000001001
1111111111111111111111111
