NO ./textures/north.xpm
SO	./textures/south.xpm
WE	./textures/west.xpm
EA	./textures/east.xpm

F 200, 225, 204
C 222, 243, 246
F 20, 2, 1

 NO111111111
 11111
10N11111111
11111
1111