NO ./textures/north.xpm
SO	./textures/south.xpm
WE	./textures/west.xpm
EA	./textures/east.xpm

F , 225, 
C  243, ,234

     1111111111
100N00111
100111111111
11111
1211