NO ./textures/north.xpm
SO	./textures/south.xpm
WE	./textures/west.xpm
EA	./textures/east.xpm

F 200, 225, 204
C 222, 243, 246

     1111111111
100N00111
100111111111
11111
1211